1111111111111111111111111111111111111111111111111111111111111
1000E00C0000000C0100000C100000010000001C0000010C0000100C00011
100000C0000000C0010000C0100000C100000010000001C0000010C000011
10000C0000000C0001000C0010000C0100000C100000010000001C0000011
1000C0000000C0000000C0001000C0010000C0100000C1000000100000011
10000C0000000C0000100C0000000C0001000C0010000C0100000C1000011
100000C0000P00C00100100C0000000C0001000C0010000C0100000C10011
1000000C0000000C00000010C0000000C0001000C0010000C0100000C0111
1111111111111111111111111111111111111111111111111111111111111
