1111111111111111111111111111111111111111111111111111111111111
1000E00C0000000C0100000C100000010000001C0000010C0000100C00011
100000C0000000C0010000C0100000C100000010000001C0000010C000011
10000C0000000C0001000C0010000C0100000C100000010000001C0000011
1000C0000000C0000000C0001000C0010000C0100000C1000000100000011
10000C0000000C0000100C0000000C0001000C0010000C0100000C1000011
100000C0000000C00100100C0000000C0001000C0010000C0100000C10011
1000000C0000000C00000010C0000000C0001000C0010000C0100000C0111
10000000C0000000C000000001C0000000C0001000C0010000C0100000C11
1000000000C0000000C00000000001C0000000C0001000C0010000C010011
10000000000C0000000C000000000001C0000000C0001000C0010000C0111
100000000000C0000000C0000000000001C0000000C0001000C0010000C11
1000000000000C0000000C00000000000001C0000000C0001000C00100011
10000000000000C0000000C0000000000000001C0000000C0001000C00111
100000000000000C0000000C00000000000000001C0000000C0001000C011
1000000000000000C0000000C0000000000000P00001C0000000C00010011
10000000000000000C0000000C00000000000000000001C0000000C000111
100000000000000000C0000000C000000000000000000001C0000000C0011
1111111111111111111111111111111111111111111111111111111111111