11111111111111111111111111111111111111
100000000000000000000000000000000000E1
100000000000000C0000000000000000000001
10000000000000000000000000000000000001
111111P111111111111C1111111111C1111001
10011111111111111111111111111111111111