1111111111111111
1P00000000000001
1000111100000001
100000010000C001
1000000111111001
10000000000C0001
1000C000000000E1
1111111111111111

