1111111111111111
1111110000000101
1000111100000001
100000010000C001
1000000111111001
10CCCCCCCCEC0011
1000C00100000011
1111111011111111

