1111111111111111
1P00100000000001
1000111100000001
100000010000C001
1000000111111001
10CCCCCCCCEC0001
1000C00w00000011
1111111111111111

